 ####    
  #  ##### 
### .#   # 
#@  $    # 
# ## ##### 
#   $  #   
### .  #   
  #  ###   
  ####   2
