###############
# #   #   ## .#
#  # $    $  .#
#      #  #   #
#    $## ##   #
#$    #  .#  $#
#   ###  ##   #
#   ## $  #  ##
#...#     #  @#
###############4
